{
  "mapX": 7,
  "mapY": 8,
  "hashMap": {
    "0xff0000": "0x400000000",
    "0x00ff00": "0x300000000",
    "0x0000ff": "0x000000002",
    "0x000000": "0x000000001",
    "0x800080": "0x600000000",
    "0x996633": "0x000000000"
  }
}