{
  "mapX": 28,
  "mapY": 31,
  "hashMap": {
    "0x00ff00": "0x300000000",
    "0x0000ff": "0x000000002",
    "0xff0000": "0x400000000",
    "0x800080": "0x600000000",
    "0xe87600": "0x000000000",
    "0x000000": "0x000000001"
  }
}